11111111
11100P11
11C00011
1000CC11
11101111
111E0111
11111111
