11111111111
11100P00011
11C000CCC11
1000CCCCC11
11101111111
111E0111111
11111111111
11111111111
