11111111111111111
11100P00000000011
1100000CCCCCC1111
11C000CC0000CCC11
1000CCCC0000CCC11
1110011111CCCCC11
111E0111111111111
1CCCCCCC000C11111
11111111100CCCC11
11111111111111111
