1111111
10C00P1
1001EP1
1111111
