1111111
10010C1
10C1EP1
1111111
