1111111
1000001
1001EP1
1111111
