1111111
10C001
101P0E1
1111111
