1111111
1CEE001
1001P01
1111111
