1111111
10C00E11
1001P01
1111111
