1111111
10C0001
1001P01
1111111
