1111111
10000C1
10C1EP1
1C11111
