1111111
10C0001
1001E01
1111111
